############~~
#XX..#.....###
#XX..#.O..O..#
#XX..#O####..#
#XX....@.##..#
#XX..#.#..O.##
######.##O.O.#
~~#.O..O.O.O.#
~~#....#.....#
~~############