~~~~~~~~########~
~~~~~~~~#.....@#~
~~~~~~~~#.O#O.##~
~~~~~~~~#.O..O#~~
~~~~~~~~##O.O.#~~
#########.O.#.###
#XXXX..##.O..O..#
##XXX....O..O...#
#XXXX..##########
########~~~~~~~~~