~~~~~~~~~~~~~~########
~~~~~~~~~~~~~~#..XXXX#
~~~############..XXXX#
~~~#....#..O.O...XXXX#
~~~#.OOO#O..O.#..XXXX#
~~~#..O.....O.#..XXXX#
~~~#.OO.#O.O.O########
####..O.#.....#~~~~~~~
#...#.#########~~~~~~~
#....O..##~~~~~~~~~~~~
#.OO#OO.@#~~~~~~~~~~~~
#...#...##~~~~~~~~~~~~
#########~~~~~~~~~~~~~