~~~~~~~~#####~~~~
~~~~~~~~#...#####
~~~~~~~~#.#O##..#
~~~~~~~~#.....O.#
#########.###...#
#XXXX..##.O..O###
#XXXX....O.OO.##~
#XXXX..##O..O.@#~
#########..O..##~
~~~~~~~~#.O.O..#~
~~~~~~~~###.##.#~
~~~~~~~~~~#....#~
~~~~~~~~~~######~