######~~###~
#XX..#~##@##
#XX..###...#
#XX.....OO.#
#XX..#.#.O.#
#XX###.#.O.#
####.O.#O..#
~~~#..O#.O.#
~~~#.O..O..#
~~~#..##...#
~~~#########