~~~~~~~#####~
~#######...##
##.#.@##.OO.#
#....O......#
#..O..###...#
###.#####O###
#.O..###.XX#~
#.O.O.O.XXX#~
#....###XXX#~
#.OO.#~#XXX#~
#..###~#####~
####~~~~~~~~~